1111111111111
1P01CC00000C1
1000011111001
100011E000001
1111111111111
