11111111111111111111111111111111111111111111111111111111111111111111111111111111
10000000000000000000000000000000000000000000000000000000000000000000000000000011
10111111111111111111111111111111111111111111111111111111111111111111111111110C11
100000000000000000000000000000C00000000000000000000000C0000000000000000000000011
1P011111111111111111111111111111111111111111111111111111111111111111111111111111
1CCC000000000000000000000000000000C000000000000000C0000000000000000000C000000011
11111111111111111111111111111111111111111111111111111111111111111111111111111C01
1C000000000000000000000000000000000000000000CCCC00000000000000000000000000000C11
10011111111111111111111111111111111111111111111111111111111111111111111111111111
100000000000000000CC0000000000000000000000000C0000000000000000000000000C00000011
11111111111111111111111111111111111111111111111111111111111111111111111111110011
1001000C00001000001000C01000000C01000C01000001111C00000000C0100000100CC000C10001
10C1001001001001001001001001001001001001001C01000C00001000001CC00010C0000C010001
10010010010010010010010010010010010010010010010000000010000010000010011111110001
100000000000000000CC0000000000000000000000000C0000000000000000000000000C00000001
11111111111111111111111111111111111111111111111111111111111111111111111111110011
1001000C00001000001000C01000000C01000C01000001111C00000000C0100000100CC000C10001
10C1001001001001001001001001001001001001001C01000C00001000001CC00010C0000C010001
10010010010010010010010010010010010010010010010000000010000010000010011111110001
10000010000CC001C0000100000100C0000010000010000000000C10001000111000000000000001
10000000000000000000000000000000000000000000000000000000000000000000000000000001
111111111111111111111111111111111111111111111111111111111111111111111111111110C1
1000000000000000000000000000000C00000000000000000000000C000000000000000000000001
10001111111111111111111111111111111111111111111111111111111111111111111111111111
1CCC000000000000000000000000000000C000000000000000C0000000000000000000C000000001
1111111111111111111111111111111111111111111111111111111111111111111111111111C001
1C000000000000000000000000000000000000000000CCCC000000000000000000000000000000C1
10001111111111111111111111111111111111111111111111111111111111111111111111111111
100000000000000000CC0000000000000000000000000C0000000000000000000000000C00000001
11111111111111111111111111111111111111111111111111111111111111111111111111110001
1001000C00001000001000C01000000C01000C01000001111C00000000C0100000100CC000C10001
10C1001001001001001001001001001001001001001C01000C00001000001CC00010C0000C010001
10010010010010010010010010010010010010010010010000000010000010000010011111110001
10000010000CC001C0000100000100C0000010000010000000000C10001000111000000000000001
11111111111111111111111111111111111111111111111111111111111111111111111111110001
1C010000C00001000001000C01000000C01000C01000001111C00000000C0100000100CC000C1001
10C10001001001001001001001001001001001001001C01000C00001000001CC00010C0000C01001
10001001001001001001001001001001001001001001001000000001000001000001001111111001
1E0000010000CC001C0000100000100C0000010000010000000000C1000100011100000000000001
10000000000000000000000000000000000000000000000000000000000000000000000000000001
11111111111111111111111111111111111111111111111111111111111111111111111111111111