1111111111
1000PCE0011
1111111111