111111111111111111111111111111111111111111
100000000010000000000000000000000000000001
100000P00000000000000000000000000000000001
111111111110000000000000000000000000000001
100000000010000000000000011111111111111111
10000C000010000000000000000000000C00000001
100000000000000000000000000000000000000001
111111111111100000000000000000000000000001
100000E00000000000000000000001111111111111
100000000000000000000000000000000000000001
111111111111111111111111111111111111111111